date,geography,geography code,Residence type: Total,Residence type: Lives in a household,Residence type: Lives in a communal establishment
2021,Hartlepool,E06000001,3844,3787,57
2021,Middlesbrough,E06000002,4626,4520,106
2021,Redcar and Cleveland,E06000003,6993,6902,91
2021,Stockton-on-Tees,E06000004,8237,8062,175
2021,Darlington,E06000005,5387,5319,68
2021,Halton,E06000006,5009,4962,47
2021,Warrington,E06000007,6875,6678,197
2021,Blackburn with Darwen,E06000008,3525,3462,63
2021,Blackpool,E06000009,5981,5807,174
2021,"Kingston upon Hull, City of",E06000010,10079,9892,187
2021,East Riding of Yorkshire,E06000011,17733,17315,418
2021,North East Lincolnshire,E06000012,7035,6919,116
2021,North Lincolnshire,E06000013,7651,7543,108
2021,York,E06000014,7383,7258,125
2021,Derby,E06000015,6870,6735,135
2021,Leicester,E06000016,4629,4455,174
2021,Rutland,E06000017,2381,2306,75
2021,Nottingham,E06000018,6755,6550,205
2021,"Herefordshire, County of",E06000019,9641,9525,116
2021,Telford and Wrekin,E06000020,8066,7939,127
2021,Stoke-on-Trent,E06000021,7460,7357,103
2021,Bath and North East Somerset,E06000022,5858,5704,154
2021,"Bristol, City of",E06000023,9490,9209,281
2021,North Somerset,E06000024,9443,9192,251
2021,South Gloucestershire,E06000025,9497,9242,255
2021,Plymouth,E06000026,18276,18036,240
2021,Torbay,E06000027,6937,6756,181
2021,Swindon,E06000030,9504,9401,103
2021,Peterborough,E06000031,6693,6539,154
2021,Luton,E06000032,3111,3072,39
2021,Southend-on-Sea,E06000033,4781,4666,115
2021,Thurrock,E06000034,3248,3215,33
2021,Medway,E06000035,8529,8423,106
2021,Bracknell Forest,E06000036,3868,3793,75
2021,West Berkshire,E06000037,5565,5465,100
2021,Reading,E06000038,3643,3590,53
2021,Slough,E06000039,1539,1530,9
2021,Windsor and Maidenhead,E06000040,4150,3977,173
2021,Wokingham,E06000041,4606,4492,114
2021,Milton Keynes,E06000042,6579,6468,111
2021,Brighton and Hove,E06000043,5617,5418,199
2021,Portsmouth,E06000044,9278,9170,108
2021,Southampton,E06000045,6361,6205,156
2021,Isle of Wight,E06000046,7194,7015,179
2021,County Durham,E06000047,22615,22253,362
2021,Cheshire East,E06000049,12827,12580,247
2021,Cheshire West and Chester,E06000050,13354,13124,230
2021,Shropshire,E06000051,14846,14535,311
2021,Cornwall,E06000052,30229,29803,426
2021,Isles of Scilly,E06000053,101,101,0
2021,Wiltshire,E06000054,31378,30785,593
2021,Bedford,E06000055,4716,4608,108
2021,Central Bedfordshire,E06000056,8599,8469,130
2021,Northumberland,E06000057,15578,15343,235
2021,"Bournemouth, Christchurch and Poole",E06000058,15894,15512,382
2021,Dorset,E06000059,22884,22374,510
2021,Buckinghamshire,E06000060,15128,14811,317
2021,North Northamptonshire,E06000061,12372,12185,187
2021,West Northamptonshire,E06000062,12658,12382,276
2021,Cambridge,E07000008,2271,2190,81
2021,East Cambridgeshire,E07000009,3035,2994,41
2021,Fenland,E07000010,4439,4377,62
2021,Huntingdonshire,E07000011,8164,7951,213
2021,South Cambridgeshire,E07000012,4678,4598,80
2021,Allerdale,E07000026,3984,3938,46
2021,Barrow-in-Furness,E07000027,2703,2665,38
2021,Carlisle,E07000028,4892,4850,42
2021,Copeland,E07000029,3054,2985,69
2021,Eden,E07000030,2166,2148,18
2021,South Lakeland,E07000031,4076,3962,114
2021,Amber Valley,E07000032,3998,3972,26
2021,Bolsover,E07000033,2798,2764,34
2021,Chesterfield,E07000034,3615,3579,36
2021,Derbyshire Dales,E07000035,2417,2369,48
2021,Erewash,E07000036,4143,4101,42
2021,High Peak,E07000037,2997,2976,21
2021,North East Derbyshire,E07000038,3528,3480,48
2021,South Derbyshire,E07000039,3570,3521,49
2021,East Devon,E07000040,8558,8383,175
2021,Exeter,E07000041,4353,4223,130
2021,Mid Devon,E07000042,3559,3528,31
2021,North Devon,E07000043,4851,4757,94
2021,South Hams,E07000044,4997,4932,65
2021,Teignbridge,E07000045,6887,6718,169
2021,Torridge,E07000046,3216,3174,42
2021,West Devon,E07000047,3508,3395,113
2021,Eastbourne,E07000061,3985,3845,140
2021,Hastings,E07000062,2914,2830,84
2021,Lewes,E07000063,3814,3714,100
2021,Rother,E07000064,4224,4097,127
2021,Wealden,E07000065,6233,6075,158
2021,Basildon,E07000066,4128,4092,36
2021,Braintree,E07000067,4662,4591,71
2021,Brentwood,E07000068,1798,1764,34
2021,Castle Point,E07000069,2623,2588,35
2021,Chelmsford,E07000070,4611,4532,79
2021,Colchester,E07000071,7172,7083,89
2021,Epping Forest,E07000072,2671,2608,63
2021,Harlow,E07000073,1922,1898,24
2021,Maldon,E07000074,2095,2045,50
2021,Rochford,E07000075,2552,2532,20
2021,Tendring,E07000076,6338,6211,127
2021,Uttlesford,E07000077,2655,2578,77
2021,Cheltenham,E07000078,4402,4278,124
2021,Cotswold,E07000079,4385,4315,70
2021,Forest of Dean,E07000080,3915,3868,47
2021,Gloucester,E07000081,5123,5051,72
2021,Stroud,E07000082,4794,4713,81
2021,Tewkesbury,E07000083,4797,4738,59
2021,Basingstoke and Deane,E07000084,6835,6742,93
2021,East Hampshire,E07000085,6007,5895,112
2021,Eastleigh,E07000086,5334,5237,97
2021,Fareham,E07000087,8942,8782,160
2021,Gosport,E07000088,8422,8341,81
2021,Hart,E07000089,4017,3925,92
2021,Havant,E07000090,7432,7333,99
2021,New Forest,E07000091,8793,8531,262
2021,Rushmoor,E07000092,5428,5318,110
2021,Test Valley,E07000093,6541,6425,116
2021,Winchester,E07000094,5556,5361,195
2021,Broxbourne,E07000095,1782,1770,12
2021,Dacorum,E07000096,3948,3815,133
2021,Hertsmere,E07000098,1927,1888,39
2021,North Hertfordshire,E07000099,3499,3404,95
2021,Three Rivers,E07000102,2023,1985,38
2021,Watford,E07000103,1562,1537,25
2021,Ashford,E07000105,4960,4892,68
2021,Canterbury,E07000106,5217,5093,124
2021,Dartford,E07000107,2328,2291,37
2021,Dover,E07000108,5710,5611,99
2021,Gravesham,E07000109,2351,2324,27
2021,Maidstone,E07000110,5664,5513,151
2021,Sevenoaks,E07000111,3344,3254,90
2021,Folkestone and Hythe,E07000112,5211,5085,126
2021,Swale,E07000113,4775,4631,144
2021,Thanet,E07000114,5768,5663,105
2021,Tonbridge and Malling,E07000115,4023,3993,30
2021,Tunbridge Wells,E07000116,3193,3099,94
2021,Burnley,E07000117,2990,2959,31
2021,Chorley,E07000118,4179,3992,187
2021,Fylde,E07000119,4256,4122,134
2021,Hyndburn,E07000120,2572,2535,37
2021,Lancaster,E07000121,5522,5403,119
2021,Pendle,E07000122,2585,2548,37
2021,Preston,E07000123,3894,3768,126
2021,Ribble Valley,E07000124,2067,2020,47
2021,Rossendale,E07000125,2283,2255,28
2021,South Ribble,E07000126,4244,4188,56
2021,West Lancashire,E07000127,4130,4045,85
2021,Wyre,E07000128,5340,5221,119
2021,Blaby,E07000129,3143,3119,24
2021,Charnwood,E07000130,5169,5087,82
2021,Harborough,E07000131,3145,3084,61
2021,Hinckley and Bosworth,E07000132,3937,3866,71
2021,Melton,E07000133,2424,2413,11
2021,North West Leicestershire,E07000134,3455,3421,34
2021,Oadby and Wigston,E07000135,1639,1574,65
2021,Boston,E07000136,2778,2716,62
2021,East Lindsey,E07000137,8511,8363,148
2021,Lincoln,E07000138,4640,4539,101
2021,North Kesteven,E07000139,10009,9902,107
2021,South Holland,E07000140,4433,4371,62
2021,South Kesteven,E07000141,8693,8579,114
2021,West Lindsey,E07000142,5746,5688,58
2021,Breckland,E07000143,7509,7336,173
2021,Broadland,E07000144,6188,6077,111
2021,Great Yarmouth,E07000145,4009,3959,50
2021,King's Lynn and West Norfolk,E07000146,7281,7189,92
2021,North Norfolk,E07000147,5698,5516,182
2021,Norwich,E07000148,3742,3641,101
2021,South Norfolk,E07000149,5665,5612,53
2021,Craven,E07000163,2101,2061,40
2021,Hambleton,E07000164,5027,4955,72
2021,Harrogate,E07000165,7076,6884,192
2021,Richmondshire,E07000166,3962,3755,207
2021,Ryedale,E07000167,2429,2384,45
2021,Scarborough,E07000168,5535,5428,107
2021,Selby,E07000169,3700,3674,26
2021,Ashfield,E07000170,4325,4276,49
2021,Bassetlaw,E07000171,4927,4824,103
2021,Broxtowe,E07000172,3820,3730,90
2021,Gedling,E07000173,3894,3858,36
2021,Mansfield,E07000174,3986,3956,30
2021,Newark and Sherwood,E07000175,5191,5107,84
2021,Rushcliffe,E07000176,3932,3775,157
2021,Cherwell,E07000177,5466,5333,133
2021,Oxford,E07000178,2474,2303,171
2021,South Oxfordshire,E07000179,5223,5103,120
2021,Vale of White Horse,E07000180,5175,5051,124
2021,West Oxfordshire,E07000181,5203,5063,140
2021,Mendip,E07000187,4548,4426,122
2021,Sedgemoor,E07000188,5576,5502,74
2021,South Somerset,E07000189,9857,9712,145
2021,Cannock Chase,E07000192,3414,3365,49
2021,East Staffordshire,E07000193,3880,3807,73
2021,Lichfield,E07000194,3607,3552,55
2021,Newcastle-under-Lyme,E07000195,4129,4083,46
2021,South Staffordshire,E07000196,3836,3615,221
2021,Stafford,E07000197,6072,5932,140
2021,Staffordshire Moorlands,E07000198,3323,3279,44
2021,Tamworth,E07000199,2498,2476,22
2021,Babergh,E07000200,3832,3764,68
2021,Ipswich,E07000202,4321,4224,97
2021,Mid Suffolk,E07000203,4617,4537,80
2021,Elmbridge,E07000207,3191,3070,121
2021,Epsom and Ewell,E07000208,1672,1639,33
2021,Guildford,E07000209,4138,3925,213
2021,Mole Valley,E07000210,2696,2630,66
2021,Reigate and Banstead,E07000211,3812,3603,209
2021,Runnymede,E07000212,2061,2003,58
2021,Spelthorne,E07000213,2512,2477,35
2021,Surrey Heath,E07000214,3246,3139,107
2021,Tandridge,E07000215,2497,2413,84
2021,Waverley,E07000216,4347,4167,180
2021,Woking,E07000217,2424,2379,45
2021,North Warwickshire,E07000218,2128,2099,29
2021,Nuneaton and Bedworth,E07000219,4442,4410,32
2021,Rugby,E07000220,3586,3506,80
2021,Stratford-on-Avon,E07000221,4864,4749,115
2021,Warwick,E07000222,3778,3704,74
2021,Adur,E07000223,2393,2347,46
2021,Arun,E07000224,7412,7210,202
2021,Chichester,E07000225,5690,5415,275
2021,Crawley,E07000226,2678,2650,28
2021,Horsham,E07000227,5154,5033,121
2021,Mid Sussex,E07000228,4673,4553,120
2021,Worthing,E07000229,3862,3714,148
2021,Bromsgrove,E07000234,3066,2964,102
2021,Malvern Hills,E07000235,3408,3318,90
2021,Redditch,E07000236,2592,2570,22
2021,Worcester,E07000237,3430,3372,58
2021,Wychavon,E07000238,5078,4965,113
2021,Wyre Forest,E07000239,3687,3619,68
2021,St Albans,E07000240,2946,2872,74
2021,Welwyn Hatfield,E07000241,2536,2475,61
2021,East Hertfordshire,E07000242,3390,3309,81
2021,Stevenage,E07000243,2237,2199,38
2021,East Suffolk,E07000244,11292,11000,292
2021,West Suffolk,E07000245,6917,6664,253
2021,Somerset West and Taunton,E07000246,7921,7718,203
2021,Bolton,E08000001,7345,7227,118
2021,Bury,E08000002,5080,5007,73
2021,Manchester,E08000003,7728,7512,216
2021,Oldham,E08000004,5939,5846,93
2021,Rochdale,E08000005,5737,5623,114
2021,Salford,E08000006,6029,5906,123
2021,Stockport,E08000007,8007,7842,165
2021,Tameside,E08000008,6697,6635,62
2021,Trafford,E08000009,5343,5234,109
2021,Wigan,E08000010,10134,10023,111
2021,Knowsley,E08000011,5132,5074,58
2021,Liverpool,E08000012,12580,12174,406
2021,St. Helens,E08000013,6302,6226,76
2021,Sefton,E08000014,10880,10636,244
2021,Wirral,E08000015,13302,13103,199
2021,Barnsley,E08000016,8383,8307,76
2021,Doncaster,E08000017,12863,12539,324
2021,Rotherham,E08000018,8214,8142,72
2021,Sheffield,E08000019,13093,12856,237
2021,Newcastle upon Tyne,E08000021,8632,8435,197
2021,North Tyneside,E08000022,8805,8745,60
2021,South Tyneside,E08000023,6464,6391,73
2021,Sunderland,E08000024,10820,10682,138
2021,Birmingham,E08000025,17771,17292,479
2021,Coventry,E08000026,7012,6860,152
2021,Dudley,E08000027,8310,8218,92
2021,Sandwell,E08000028,5843,5795,48
2021,Solihull,E08000029,5851,5730,121
2021,Walsall,E08000030,6486,6379,107
2021,Wolverhampton,E08000031,5498,5414,84
2021,Bradford,E08000032,12390,12229,161
2021,Calderdale,E08000033,6557,6455,102
2021,Kirklees,E08000034,11791,11586,205
2021,Leeds,E08000035,20401,20003,398
2021,Wakefield,E08000036,11723,11484,239
2021,Gateshead,E08000037,7358,7235,123
2021,City of London,E09000001,144,139,5
2021,Barking and Dagenham,E09000002,2168,2135,33
2021,Barnet,E09000003,3917,3822,95
2021,Bexley,E09000004,4958,4872,86
2021,Brent,E09000005,2106,2024,82
2021,Bromley,E09000006,6673,6533,140
2021,Camden,E09000007,1892,1828,64
2021,Croydon,E09000008,5139,5031,108
2021,Ealing,E09000009,3294,3224,70
2021,Enfield,E09000010,3320,3257,63
2021,Greenwich,E09000011,4483,4361,122
2021,Hackney,E09000012,1633,1589,44
2021,Hammersmith and Fulham,E09000013,2222,2188,34
2021,Haringey,E09000014,1849,1839,10
2021,Harrow,E09000015,2723,2687,36
2021,Havering,E09000016,5069,4980,89
2021,Hillingdon,E09000017,4831,4731,100
2021,Hounslow,E09000018,3491,3454,37
2021,Islington,E09000019,1707,1648,59
2021,Kensington and Chelsea,E09000020,2021,1727,294
2021,Kingston upon Thames,E09000021,2659,2552,107
2021,Lambeth,E09000022,3051,3001,50
2021,Lewisham,E09000023,2925,2883,42
2021,Merton,E09000024,2888,2814,74
2021,Newham,E09000025,2064,2052,12
2021,Redbridge,E09000026,2804,2740,64
2021,Richmond upon Thames,E09000027,3506,3457,49
2021,Southwark,E09000028,2877,2814,63
2021,Sutton,E09000029,3569,3504,65
2021,Tower Hamlets,E09000030,1932,1885,47
2021,Waltham Forest,E09000031,2476,2442,34
2021,Wandsworth,E09000032,4137,4022,115
2021,Westminster,E09000033,2192,2128,64
2021,Isle of Anglesey,W06000001,3221,3182,39
2021,Gwynedd,W06000002,4177,4077,100
2021,Conwy,W06000003,5651,5508,143
2021,Denbighshire,W06000004,4309,4213,96
2021,Flintshire,W06000005,6770,6709,61
2021,Wrexham,W06000006,5066,4892,174
2021,Ceredigion,W06000008,2525,2483,42
2021,Pembrokeshire,W06000009,5832,5718,114
2021,Carmarthenshire,W06000010,7280,7175,105
2021,Swansea,W06000011,8074,7919,155
2021,Neath Port Talbot,W06000012,5125,5057,68
2021,Bridgend,W06000013,5862,5660,202
2021,Vale of Glamorgan,W06000014,5892,5762,130
2021,Cardiff,W06000015,8591,8362,229
2021,Rhondda Cynon Taff,W06000016,7855,7791,64
2021,Caerphilly,W06000018,6349,6303,46
2021,Blaenau Gwent,W06000019,2137,2102,35
2021,Torfaen,W06000020,3679,3637,42
2021,Monmouthshire,W06000021,4212,4134,78
2021,Newport,W06000022,5144,5092,52
2021,Powys,W06000023,5736,5654,82
2021,Merthyr Tydfil,W06000024,1844,1831,13
